NO ./texture.xpm




SO ./texture.xpm



WE ./texture.xpm



EA ./texture.xpm





F                   220,100,0



C 225,30,0





1111111111111111111111111
11000000000000011111
11111110000000000001
1000000000000011111111111111
1111111111111110000000000001
1110111111111111111111111111111
11111111111111011100000010001
1111011111111101110101001111
10000001101011111000000100011
100000000000000011000111110001
100000000000000011010100001101
11000001110101011111011110N01111111111
11110111 1110101 101111010000000000111
11111111 1111111 1111111111111111111
