NO ./pics/bluestone.xpm




SO ./pics/colorstone.xpm



WE ./pics/greystone.xpm



EA ./pics/redbrick.xpm





F                   220,100,0



C 225,30,0





1111111111111111111111111111111
11000000000000000000000000000011111
100000000000000000000000000000000001
100000000000000000000000000000000001
1100000000000000000000000000000000001
11000000000000000000000000000000000001
11000000000000000000000000000000010001
110000000000000W0000000000000000000011
10000000000000000000000000000000000001
10000000000000000000000000000000000001
10000000000000000000000000000000000001
110000001000000010000000000000000000001
10000111 1110101 101111010000000000111
11111111 1111111 1111111111111111111
