NO ./pics/bluestone.xpm




SO ./pics/colorstone.xpm



WE ./pics/greystone.xpm



EA ./pics/redbrick.xpm





F                   220,100,0



C 225,30,0

       
11111111111111111111111111111111
10000000000000000000000000000001
10111111111111111111111111111111
101
101
101
101
101
1011111
1E111
1111111
