NO ./pics/bluestone.xpm




SO ./pics/colorstone.xpm



WE ./pics/greystone.xpm



EA ./pics/redbrick.xpm





F                   220,100,0



C 225,30,0

    111
   1001
 1100011
 11111
