NO ./texture
SO ./texture
WE ./texture
EA ./texture

F 220,100,0
C 225,30,0

        1111111111111111111111111
          10000000110000000000001
        1111000001110000000000001
           1000000000000000000001
111111111111000001110000000000001
           1001001110111111111111
11111111111111011100000010001
11110111111111011101010010001
01000000110101111100000010001
10000000000000001100000010001
100000000000000011010100100001
11000001110101011111011110N0111
11110111 1110101 101111010001
11111111 1111111 111111111111