NO ./texture




SO ./texture



WE ./texture



EA ./texture





F                   220,100,0



C 225,30,0






        1111111111111111111111111
                 1100000000000001
        1111     1110000000000001
           1        100000000000001
111111111111      1110000000000001
           1  1  1110111111111111
11111111111111011100000010001
11110111111111011101010010000
01000000110101111100000010001
100000000000000011000111110001
100000000000000011010100001101
11000001110101011111011110N01111111111
11110111 1110101 101111010000000000111
11111111 1111111 1111111111111111100
         
   

