NO ./pics/colorstone.xpm

SO ./pics/colorstone.xpm

WE ./pics/colorstone.xpm

EA ./pics/colorstone.xpm

F 100,100,100

C 150,150,150

11111111111111111111
11000010000100000111
10100000000000000001
100010000100001000E0
10100000001011000001
10000010100100001001
10001000000000000011
10011000000000000011
10010000001100010001
11111111111111111111
